#######
#@    #
#  $  #
#    .#
#######